{
    "1": "爱",
    "2": "爱好",
    "3": "八",
    "4": "爸爸",
    "5": "吧",
    "6": "白",
    "7": "白天",
    "8": "百",
    "9": "班",
    "10": "半"
}